XXXXXXXX     E       X   X
X                    X   X
X                    X   X
X                    X   X
X      X             X   X
X      X             X   X
XXXXXXXX  XX  XX  XX XXXXX
                         X
                         X
XXXXXXXX    XXXXXXXXXXXXXX
X          X
X          X
X          X
X          X
XXXXXXXXXXXX